XXXXXXXXXXXXXXXXXXXXXXXX
    XXXXXXXXXX        XX
XX          XX  XX    XX
XX      XX  XX        XX
XX  XX  XX  XX  XXXX  XX
XX  XX  XX  XX  XX    XX
XX  XXXXXX  XX  XX  XXXX
XX  XX      XX  XX  XXXX
XX  XX  XXXXXX  XX    XX
XXXX            XX    XX
XX        XXXXXXXX    
XXXXXXXXXXXXXXXXXXXXXXXX
